*************************
*************************
****                 ****
**** *************** ****
****  ************** ****
*****  ************* ****
******  ************ ****
*******  *********** ****
********  ********** ****
*********  ********* ****
**********  ******** ****
***********  ******* ****
************ ******* ****
***********  ******* ****
**********  ******** ****
*********  ********* ****
********  ********** ****
*******  *********** ****
******  ************ ****
*****  ************* ****
****  ************** ****
***  *************** ****
**  **************** ****
*  *****************F****
*************************