*************************
*                      F*
* ***********************
*                       *
* ***********************
*                       *
* ***********************
*                       *
* ***********************
*                       *
* ***********************
*                       *
* ***********************
*                       *
* ***********************
*                       *
* ***********************
*                       *
* ***********************
*                       *
* ***********************
*                       *
* ***********************
*                       *
*************************