*************************
*F                      *
************* ***********
*                       *
**** ********************
*                       *
***  ********************
*                       *
********* ***************
*                       *
********************* ***
*                       *
***** *******************
*                       *
* *************** *******
*                       *
***** ************** ****
*                       *
***** *******************
*                       *
******* *****************
*                       *
***************** *******
*                       *
*************************