*************************
***                    **
***        *********** **
***        *********** **
***** **************** **
***** **************** **
***** **************** **
***** **************** **
***** **************** **
***** ************      *
***** ************      *
***** ************      *
***       ********     F*
********* ***************
********* ***************
*********               *
*******************     *
*******************     *
*******************     *
*******************     *
********************* ***
********************* ***
********************* ***
*                     ***
*************************