*************************
*F                      *
*********************** *
*                       *
*********************** *
*                       *
*********************** *
*                       *
*********************** *
*                       *
*********************** *
*                       *
*********************** *
*                       *
*********************** *
*                       *
*********************** *
*                       *
*********************** *
*                       *
*********************** *
*                       *
*********************** *
*                       *
*************************